Function,TxHash,BlockNumber,gasUsed,TimestampTxSubmitted,TimestampTxMined,MiningTime,ConfirmationTime
deploy,0xe7c71d6e89201fbf362105652395056106bdb28ad733b5015e1dafaaa09110b5,7456060,224195,1553763217,1553763244,27,152
deploy,0xd03da80113573869207f483cc5db584614210cfa3238e4b65d29520f122b8335,7456062,41908,1553763257,1553763262,5,137
deploy,0xc283a8d40a55e9b93f444b5338b21ef6f86f71ed5dc39b9975bab918b61140c4,7456066,798352,1553763265,1553763292,27,195
deploy,0x6fdcda966224b76294f2ec1667dfe6fc329a3372582f5b49f5d7dcc948f01f18,7456069,68794,1553763295,1553763311,16,183
deploy,0x124dcce2991a372907a6de7a488e45415ea64f5953de8cbfb150b9913d501822,7456074,2683314,1553763332,1553763394,62,234
deploy,0x526012bc9b9babe687dae5c7358a99d40b28dd41db38d2bc456fb3586a3caf2f,7456079,3292484,1553763424,1553763466,42,162
deploy,0x91f4fb83517cdfe467c0b10d7f543ee0711cb429f2f3eea9229b91bfedbdbc73,7456084,6588890,1553763477,1553763544,67,145
deploy,0xd801f34b75fad2afbd058cb3736166f938f63f2c72c6525530b98a14c6d5faaa,7456087,26908,1553763565,1553763570,5,95
activateInBlock,0xba42f9dbd2e2ead17f0bda7c2dc0a3d314228a61e8a2e908227766d7cf764e0c,7456159,155155,1553764327,1553764330,3,171
getOracleCurrencyConversion,0x84a645605d0c6eafa66ba4a6049b639de2e49aa3ec05d846a447ca273882167f,7456170,216884,1553764471,1553764488,17,180
getPrefixCost,0x467eddcfbfc99a5979d025cfdaa530474487f838686a6525f8e9c08b0ba60479,7456178,49703,1553764556,1553764615,59,144
prefixRequest,0xbe6dccb8e3a6ac279bd231ac731a388e13a8bfd137aae55da75c17b60d7adb00,7456201,236002,1553764798,1553764811,13,165
prefixRequest,0xe9b1d60f034af2e383344dc9502c86f1c6eeec999a687672a30fe55129b30e70,7456221,207584,1553765076,1553765083,7,201
prefixRequest,0x189d6ecba724b7bf737d25d129ded94703960e97e6c944ca88da035eebb732d6,7456231,207690,1553765249,1553765268,19,89
prefixRequest,0x54f409fad28e8fb8f710caa5d44275220fdd2d54906f008fe2cad52b855872ed,7456245,209272,1553765350,1553765366,16,232
prefixRequest,0x7988313f862b7753b0e5f9dcb5d763243fe03980f4ba2e29f5c56b94b67cdede,7456266,207690,1553765642,1553765671,29,193
prefixRequest,0x344d565df54978b80535cadcef99ae6bdcbd224c433f2ddfe86339e259a334d2,7456280,209272,1553765788,1553765855,67,201
prefixRequest,0x60d1a9eb9854daeac1f25358eb3f426a19c1179d6b2621cd99c1b2d893bdeafa,7456289,209378,1553765946,1553765972,26,152
prefixRequest,0xb17765877fbb5724ce281a798f54ea7977c7096af7e8c468df72002d826273e6,7456303,210960,1553766067,1553766114,47,236
prefixRequest,0x3286bf1919ae3e9d2b31380441fc0112020662ada8ce0a5d0808d95358c877a3,7456314,207690,1553766262,1553766291,29,211
prefixRequest,0x8908aec703bc5d19004befb1f0d6b6e382757d9b3bb2d881a7145077959bf25f,7456333,209272,1553766433,1553766603,170,316
prefixRequest,0x31901bbf79014c6839397bc6336a6df8661702a8cdec8287ba43cfbc60b4cdbc,7456778,209378,1553773216,1553773228,12,207
prefixRequest,0xd0b7e76f2316173c45ac60df10bd2063d8236d5391fc7ff2929d0549173c8453,7456782,210960,1553773244,1553773314,70,236
prefixRequest,0xe8821780b16f2aeec22eb3e5248783c25a3f28c69c931472cee7427afdebfbb6,7456787,209378,1553773329,1553773391,62,202
prefixRequest,0x6212007e96a2e41b0ed450a908e067591f6c00f81e3957104530a6421185a1e9,7456790,210960,1553773398,1553773423,25,157
prefixRequest,0x5e59c500b152eded4be1202a9a9216710df0980ee7c0645882d61c36987d58f9,7456792,211066,1553773429,1553773449,20,166
prefixRequest,0x3f32ad801008b475a963743c06437d0f0fe63cbabb94a285d1c91403bae68a36,7456794,212648,1553773461,1553773480,19,160
prefixRequest,0xb84752252304c7ec7be16605968fe545c5efe3dec354d9b975d667cfdc73ef59,7456796,207630,1553773487,1553773499,12,179
prefixRequest,0x0f326d1e510d0d267eee707ad96d232aafd93b8ccbaaa08725f5c9f8f62503eb,7456800,209212,1553773515,1553773539,24,220
prefixRequest,0x4f7bfa8769cc8c1785350ce86322a232734037dce99e5cca2f9c3d6eadb6529e,7456803,209318,1553773546,1553773569,23,200
prefixRequest,0xc59ba1d277f544e6260d0aafe515a4b25c0b71a3bc6fff401c5a243e5a20917d,7456804,210900,1553773576,1553773595,19,173
prefixRequest,0x16e41345f13eb4b4cf6f0cf70ad7846e8e0c7bd2ec1ab7ce420350f2b718dab1,7456806,209318,1553773602,1553773621,19,168
prefixRequest,0xe23847243f9cc1d9e024f4071a926a3fea3424c2323d2f0a82c6c2b18a14e55a,7456808,210900,1553773626,1553773666,40,154
prefixRequest,0x74abffd28c870854253dde36f8db68a4f9adf0e2d347a3f0c9753f374ecfda8d,7456809,211006,1553773671,1553773683,12,113
prefixRequest,0x7fa945abe28fc2f4784d4926b478c53acef0266cf1fc8072982c06a6295ae8df,7456811,212588,1553773694,1553773729,35,103
prefixRequest,0x6730fd3ab8608d48e4e27c52e812b9421c7ec11837e854c42cb4504d8d98f80c,7456814,209318,1553773740,1553773743,3,75
prefixRequest,0x0bdb6c7baa2c7db8e5ae9d80d17b79b0acd49cd113ffc17e230824586d14cfda,7458316,210900,1553793576,1553793615,39,208
prefixRequest,0x3587aab9cbcfcd66006c07b477f846c0ffd90ea885f544bcdc3d01417abf7636,7458320,211006,1553793658,1553793678,20,172
prefixRequest,0x6dad1c61e39a0d8bd1d84e9598bad2d9930ea22a0ccb1f0f27e8e3f4b1f7392a,7458322,212588,1553793695,1553793730,35,168
prefixRequest,0x6099dfa143c4d99cdb68127114f1373a33f608c0ce13f8e5cfdc3da631b73a98,7458325,211006,1553793742,1553793772,30,133
prefixRequest,0x08baa21037ec296c31ce9d00e23b81f623bfb7b8e36c5f9dddd48c28de9474ac,7458331,212588,1553793791,1553793797,6,131
prefixRequest,0xbd4a90ab06526f32b4dd8202f07e359acf82d542f2e816ef590891731f22ebb8,7458335,212694,1553793812,1553793869,57,135
prefixRequest,0xf01d95d9fea192b7b0949764f8c595f2c9f63244e42a15d8f7ae90a4fd8e3f5b,7458338,214276,1553793877,1553793885,8,115
prefixRequest,0xeacaf1b75e732bd97fd72ce4dc22439501172fab279d431697b28bc755046507,7458339,207730,1553793896,1553793904,8,103
prefixRequest,0x9d8135b883b90a50d9b36b8aacff4e5b1c002829324f8cc5722f153515dcbdce,7458341,209312,1553793914,1553793918,4,97
prefixRequest,0xa9c215edae3c3ffc350013b1fd60fa99a5abdf5b700ebba679c748581787edf5,7458345,209418,1553793932,1553793944,12,99
prefixRequest,0xdcaecd86035f1cb323d73efc359cc8113d522efb54c5d7dca0fab99c57c7bbc3,7458348,211000,1553793952,1553793985,33,138
prefixRequest,0x2e89d26a5a697e0483f65356f052d053c583566a99206a9f3158f4b63d546fb9,7458351,209418,1553793990,1553793999,9,122
prefixRequest,0x9224f4a8a9cf1dd5a05b8a0399a9d5e7d0fb49dcc2c2219a4514af7eac65a692,7458354,211000,1553794011,1553794015,4,134
prefixRequest,0x3a7359e8285ff57a231ca6a6ac5c1c5257ddff4ddb7d8048dd7f01db3f6c319e,7458358,211106,1553794034,1553794039,5,191
prefixRequest,0x9e0fbd48842ed41e70e13442408e45d963e23c59ae65b3a33fac16afc9116fad,7458360,212688,1553794056,1553794090,34,177
prefixRequest,0xaacc5e98c55fed58c4e0f482b0cccf7285353568a3fe72993e285c78da4c3aff,7458362,209418,1553794098,1553794107,9,153
prefixRequest,0xee7409d8725f2606a6e8ffa3c7df542259b96bde262229125aa908fd2931c608,7458366,211000,1553794117,1553794145,28,170
prefixRequest,0x75e6eb3646b8e01f4bf78f56ad9add7cc8f73bdbb932a4d45516fd4e805f847b,7458369,211106,1553794150,1553794218,68,222
prefixRequest,0x1f8a067d79537ef58dade4b4a1fee542ea5d8b8b4f31b314ed74234ba4883cd1,7458371,212688,1553794222,1553794231,9,225
prefixRequest,0x5ed3065fe802c2f2da39db205af34c79cdf3b8c9dfceaa6dbe1fb9060a1d764a,7458377,211106,1553794243,1553794279,36,275
prefixRequest,0x538a50e8b760bdda8e02450260d6cb535d059349132b711e5988788142359f44,7458382,212688,1553794293,1553794378,85,308
prefixRequest,0x3bc890fad962bf9eba11d0d8b82c5f4058a67283fb2e295f6f65290e5936ce6b,7458384,212794,1553794386,1553794456,70,221
prefixRequest,0x14a7c046c273fce93bc59b98f7dcebc0faed42b161f349632b7c6bff727ce08e,7458387,214376,1553794469,1553794503,34,161
prefixRequest,0x2a6b00429eaa01adf0aa1edafca51dddd98027f9ec510586801570348005f8d0,7458392,209358,1553794522,1553794588,66,194
prefixRequest,0x48b94b7bca9ffc8a5150db3ca93b285b3c3e15fea85c619a9cb6177948884770,7458395,210940,1553794600,1553794603,3,137
prefixRequest,0xcc924c5297548fee42079e1f968288e70ef32aae05eb268979c81eed50b2ae48,7459230,211046,1553806266,1553806288,22,161
sequentialAllocationPrefixRequest,0x0d346bebd3c853564b27b836745473912fc12a2fbb17869e2aada7505a16807f,7456216,230941,1553764956,1553765043,87,292
sequentialAllocationPrefixRequest,0xecea40bc61d29b1ab532d406c317cd81eafff131d4dc4ad62806b230a6ef911b,7456227,232399,1553765141,1553765174,33,174
sequentialAllocationPrefixRequest,0x1cea1bb679b70937be26a1d6c3f4e0b79260c7d4926a89124a7a12629b550322,7456239,232549,1553765308,1553765315,7,199
sequentialAllocationPrefixRequest,0x81aecc8319f817a78b707c96d88766fb2061e3b1eb811318843145b9aa165623,7456255,234007,1553765409,1553765558,149,267
sequentialAllocationPrefixRequest,0x1796d74976159173b9db66c8557360e34788e7fd6ca836703d958ed474e48e53,7456273,232549,1553765706,1553765759,53,221
sequentialAllocationPrefixRequest,0xc7611dcd97fb79253ddacaab2a7c558c86ac5e71c592f8e224a4a16fac996a80,7456285,234007,1553765892,1553765927,35,152
sequentialAllocationPrefixRequest,0x11f36aba21d2bd5fe381bc3fc5ce18b538c8d9b3b3560ba8d625cbd5a1bed171,7456296,234157,1553766010,1553766039,29,224
sequentialAllocationPrefixRequest,0xb440fd62cacb9c839c1caf1311c1374329cf107dd7f12ad400a84347c100f931,7456308,235615,1553766144,1553766234,90,205
sequentialAllocationPrefixRequest,0xe567a694d9232ff2bde3356c9b91320e119915d87d28240ab7f3b994549d5f87,7456324,232549,1553766362,1553766405,43,288
sequentialAllocationPrefixRequest,0xac5bb319e0a9b24c5aaf24f85904bd73b7590f8ffd31b0172dec5367268bd913,7456345,234007,1553766705,1553766749,44,170
sequentialAllocationPrefixRequest,0xb264fc3771c1a520780db3f2681a688ea18f0c7173c3100e2bdefb23c9b23f87,7456828,234157,1553773830,1553773846,16,191
sequentialAllocationPrefixRequest,0xac6280eefeb4fc382e859fa7c5e3c22792ca49d4be3cbaab93776d47b2fb4588,7456832,235615,1553773876,1553773885,9,185
sequentialAllocationPrefixRequest,0xb2020c9f7e4c74dfdd7d06bc1794a15d95f260021b5787410a56d562ea9f1309,7456834,234157,1553773906,1553773918,12,158
sequentialAllocationPrefixRequest,0xf1318490dbc666c86b4fa6765fa1881ed6d70bfd9f5c67dea248dd6966604bf7,7456838,235615,1553773963,1553774010,47,165
sequentialAllocationPrefixRequest,0x9767c7122067a206011f053830721da51042f2ea0191629aa83e654d9627a293,7456842,235765,1553774030,1553774043,13,122
sequentialAllocationPrefixRequest,0x26732ef19efdd6e25dbc0b4ab041d7d87b30c362333421b33e96257a9827d751,7456846,237223,1553774061,1553774064,3,136
sequentialAllocationPrefixRequest,0x80a198c1b45897e082b503010727a1195f24ffffa4f61b3a0820f54dd564d847,7456851,232523,1553774095,1553774129,34,158
sequentialAllocationPrefixRequest,0xccea999015fe06f1c83b8aa6135fb2ba5e9fa129ed780bc4d3fd0fc5c8d1a098,7456857,233981,1553774181,1553774196,15,172
sequentialAllocationPrefixRequest,0xd0021c41a53786748542b8753231fdcb401018387131249b82e84db7c7a17c71,7456862,234131,1553774215,1553774237,22,169
sequentialAllocationPrefixRequest,0x0d76ae9c250447cbd9a7b1fe87c4f4a7e24ea361adb50265f594102f1d048ecd,7456865,235589,1553774269,1553774284,15,150
sequentialAllocationPrefixRequest,0x399e84ab5e5e4d3688f4b798e41de5b7eacfc953fa293c6b38221c896982a878,7456868,234131,1553774301,1553774346,45,169
sequentialAllocationPrefixRequest,0x0b2a29ff2e71069fec8a69d2ac4b80bc2255c7975e015277538531c3b3ccf6aa,7456875,235589,1553774382,1553774400,18,182
sequentialAllocationPrefixRequest,0x2150428b315dbebd8e9e036534c25e919b6f2b6a3164b01763ece475321ffa57,7456886,235739,1553774413,1553774554,141,287
sequentialAllocationPrefixRequest,0xd46252cd914492bc58d7713c6a531153676d907174606adad14abffb5ada8723,7456890,237197,1553774578,1553774611,33,150
sequentialAllocationPrefixRequest,0x7d875e8be5e6aea40301842394e16841f0ce727148feb8d08b8e9bd180a36119,7456895,234131,1553774656,1553774664,8,122
sequentialAllocationPrefixRequest,0x3a2f93fe88a5f0cfd6561426b0423717bb31f8bdc6a4a4aff5c3a58be0a264dd,7458427,235589,1553794968,1553794971,3,212
sequentialAllocationPrefixRequest,0x3e3aa88c5b352a2ce612c7bdd8ffd85afda280197fe2c4ec90e55ad6bb788780,7458433,235739,1553795000,1553795035,35,302
sequentialAllocationPrefixRequest,0xf8e1ab538eabc9b1eabab103c82d89c6935b565789c1273ad69e19c96ac59cb7,7458458,237197,1553795468,1553795484,16,164
sequentialAllocationPrefixRequest,0x5545592986fbce222fc86f244c4944051a7c2155bb68f50d05d71193de3724c7,7458461,235739,1553795511,1553795521,10,148
sequentialAllocationPrefixRequest,0x72e4d2dbf55585fee3eabbcc97682ee83eee8ded733b4bfc8915d319b3b02d26,7458463,237197,1553795543,1553795567,24,148
sequentialAllocationPrefixRequest,0x5ca34bf14ffac5951dfefd5d634fabe178ca20a54a0bb4ef34c0171e1ac162b5,7458470,237347,1553795628,1553795632,4,257
sequentialAllocationPrefixRequest,0x3a8b550d91a8fbf60e8012ac095aa00554847e43d1b5aee6dc47aff8f5ab1333,7458473,238805,1553795655,1553795659,4,316
sequentialAllocationPrefixRequest,0x5081bead6dcfc098dae7ff49dec253e2ed417c537d060daa0ced69c5c0bb1dbf,7458476,232673,1553795689,1553795762,73,321
sequentialAllocationPrefixRequest,0x28734d156ecd32c80369b08c6d915b0138e110ce351acdcc2557a3c8e439a1f7,7458482,234131,1553795842,1553795885,43,260
sequentialAllocationPrefixRequest,0x9d44dcd489c350fc5deadcee7dee6f697651b298072b7a124821dbbc464f500f,7458486,234281,1553795902,1553795995,93,238
sequentialAllocationPrefixRequest,0x6b1c49e94f81e9d8ad2ea5837164756e2a380d18ceeca755e03f2ab45d0154ac,7458490,235739,1553796014,1553796046,32,162
sequentialAllocationPrefixRequest,0xd5caf3ec6df84e5219f91b658864356c4c95dfe5edcc8e0c10a8a7f81ed25c9f,7458494,234281,1553796068,1553796102,34,182
sequentialAllocationPrefixRequest,0x62e70093cc1e4777a85e616dd0701bb1fc5b30cfc84e5dbaa1c8ef84433dc3e6,7458499,235739,1553796122,1553796143,21,241
sequentialAllocationPrefixRequest,0xe1c915ce14d943691628c5f8e27ace119103bf7184cc2791f704f273d4d28d6f,7458501,235889,1553796162,1553796175,13,234
sequentialAllocationPrefixRequest,0x00413524682640725c2a3c07c1776f79de51691904dcf1a4112b075787a2ad65,7458505,237347,1553796212,1553796226,14,229
sequentialAllocationPrefixRequest,0x4b31624223999be350bf2dc396fac72bfcb4916d13ceec66b2cf60ab2b659644,7458512,234281,1553796251,1553796365,114,244
sequentialAllocationPrefixRequest,0x8e5e68b7f466b9dc872cccf609ff74c5f1c1373a6b43c44999e606185ffa7496,7458516,235739,1553796381,1553796430,49,222
sequentialAllocationPrefixRequest,0xba7ce6aa28df9ac343765c6a054b55a0b4c5a7d0f7d63bcd6f44f81839f177a3,7458519,235889,1553796451,1553796459,8,175
sequentialAllocationPrefixRequest,0xbdeb2af221d3272971226de5aec32944af741748eaa8ba4a41711e0fe7fed2d2,7458522,237347,1553796481,1553796492,11,214
sequentialAllocationPrefixRequest,0xdaee4f847bcc177f510f42d7101c0f948b738a4f36d2e6b91a106d8ac052461d,7458526,235889,1553796516,1553796593,77,220
sequentialAllocationPrefixRequest,0x032d0b2ef21b508a1451925343e2ad54cf2b8ff8d66dacd1459c04882ff5e533,7458530,237347,1553796614,1553796618,4,214
sequentialAllocationPrefixRequest,0x96eb89b87d4e8aa252daab325d42a69d98b7964fa579be1ff4a2128b0f010da2,7458535,237497,1553796651,1553796705,54,291
sequentialAllocationPrefixRequest,0xc3bbaa4b914bcf14cc8b4587fcb42e4fd652fdd0934a12f783aedf6e4d11f826,7458536,238955,1553796725,1553796733,8,276
sequentialAllocationPrefixRequest,0x8ca9fcaf8c3311c300505224dac4f6a92d31634eb742b54fc7dc3b0a30fde9e0,7458543,234191,1553796757,1553796851,94,433
sequentialAllocationPrefixRequest,0x713de3cf4b519c249b33def05c67c190d6f803dce54fc0231fb43e5ed611202f,7458545,235649,1553796881,1553796890,9,321
setPolicyURI,0x182cbf4961a13c5abb6f68d1ececa0b0d274e3fdf91c98ed3179673882b77a76,7456408,88664,1553767471,1553767486,15,206
setPolicyURI,0x0708f3b082b20d29259c14f0e302cc49c78d20b3ac601f512f41109daf60e0b6,7456410,88664,1553767496,1553767525,29,204
setPolicyURI,0x781713c9e67ffd5280528ed4201e3151403a1b194b9d7fa8f5a09437780f2e00,7456414,88664,1553767534,1553767591,57,251
setPolicyURI,0xe0ab6b287bfe77091f568ead2f664b797de668ba3e9adcf7a1f738718882c56b,7456418,88664,1553767605,1553767643,38,203
setPolicyURI,0x2223d2d638d47e6a4d0b0a215efd3999b1dd957892d4dfcb7994f4d4f2ede544,7456421,88664,1553767664,1553767688,24,221
setPolicyURI,0x82c8d3af17557e3c220f0bd9d6d22c2e6410bfffc9bff236493cb2b8396a80af,7456425,88664,1553767751,1553767776,25,159
setPolicyURI,0x2000a0610bd349188b018be905392e338e02a28bc2bd01f74d8ea8f66a301818,7456433,88664,1553767869,1553767885,16,193
setPolicyURI,0x0c2f6fe869353e032f4ced7164db1dd903e3410c6d7985bb8e9692f63b53eda3,7456439,88664,1553767920,1553767929,9,259
setPolicyURI,0xa35c2d2d0bc32cf63e09b816c8bcfcac3e82d2a19d32c84458ae5d5856b6e520,7456442,88664,1553767956,1553768040,84,293
setPolicyURI,0x7ba20ad9ed028bb8aaf164e92329257d7dd38165627237cc08ba381a13f008fb,7456448,88664,1553768076,1553768109,33,229
setPolicyURI,0x0aa79b79693656167e395eedff21ef5046256be645beb74e9da278d5ba8eee53,7456963,88664,1553775440,1553775460,20,99
setPolicyURI,0xd6ed6fefd9945e12f4b43487e58982593c7b85d06af5faedb46848884cf135e6,7456969,88664,1553775489,1553775501,12,112
setPolicyURI,0x2c6224d5b48103acab45bfd667c77f09ae3c99ffd390a99861f2730249c8d9db,7456973,88664,1553775526,1553775533,7,158
setPolicyURI,0x28cc496de08475dac05efa628c205fc041c7e98a98e1bc1b81c54a3a97a4ca97,7456977,88664,1553775545,1553775560,15,174
setPolicyURI,0xb1ecab74a9965a67c4656658f13ffe82b54e2e6fd6a284fac2170243fd019713,7456981,88664,1553775587,1553775601,14,185
setPolicyURI,0x14ad0cbb136a3502ed0be60444b42653d4b257d1f1da944ba562219bdb9dc842,7456984,88664,1553775630,1553775672,42,197
setPolicyURI,0x8d748edb4e2045814e1f0b43851a07142695b2ce9866d257286d6fc1fc203bdd,7456987,88664,1553775683,1553775694,11,171
setPolicyURI,0xa6bd04983ce970c646d8d40b2a91f8fbe80a7f4e2403fc42fa5697b5a9d32dfc,7456990,88664,1553775704,1553775741,37,222
setPolicyURI,0xbeb9ccebc53a1c36315b9ade9331242d55b04804c645bc6223754385cfb25fa1,7456993,88664,1553775751,1553775772,21,210
setPolicyURI,0x8e03b450d7ebe10c535d9af7dca805fa80d1e03c9d3e6b42c62c674fb8da2632,7456995,88664,1553775782,1553775823,41,195
setPolicyURI,0xfdc25d54ecd07a1ab127a3cb60ca0207c2eb712c1a8108835a703a2debd1f898,7456998,88664,1553775831,1553775840,9,210
setPolicyURI,0xcea8c78717f3ad00283a7444b5277aa4352912f43b630edce99efe544e862632,7456999,88664,1553775852,1553775854,2,195
setPolicyURI,0x7fdc5a014107af40579f6033c88b5fc306f8a7330639e59d3a000e2e59b3942f,7457004,88664,1553775873,1553775954,81,243
setPolicyURI,0xdccbcf067d58f7051c3500a7a84699123a2c4d261e0b4b34d94b59e6cf542fe1,7457009,88664,1553775967,1553776028,61,189
setPolicyURI,0x2877c2edfe8caa281d096c96a05dd97f786e6b37042e1946fcfc7bad9bd741fa,7457011,88664,1553776042,1553776047,5,127
setPolicyURI,0x2f9c1f5c5696ccea603c295680ce5171dcbbc69008530aa2303297df336ff74c,7458637,88728,1553798291,1553798356,65,182
setPolicyURI,0x05b4189e795a751a3660e5f62c6410296302e613b72e7ff0c950bc01fe7ecb35,7458640,88728,1553798369,1553798379,10,150
setPolicyURI,0xe35bd37b432fea0730c01e8b68e5ff63b8a92fca22d1ffa7c3677b976ff35754,7458644,88728,1553798389,1553798411,22,215
setPolicyURI,0x482dcd6d999468530778bea1167c3ce6a09a1f4baa78ab5bfbecb35c377db64b,7458645,88728,1553798421,1553798428,7,211
setPolicyURI,0xe882a60aa47013801f45b3c9042ed68087490283a1e9db13163fd9b03a076e58,7458671,88728,1553798799,1553798839,40,192
setPolicyURI,0x387737739325b4de00e00f6625552bfe57580b27aecc7a50f0d66aab6119c1a9,7458673,88728,1553798849,1553798855,6,171
setPolicyURI,0xb07ae0a8d28160d62778f99364afe39dd70e27f073e632cfc4575a82fd568f08,7458676,88728,1553798871,1553798883,12,166
setPolicyURI,0x4542574ec81f574b72071c80c82c1d2ceac707e57e5650f2774d50e53587e427,7458680,88728,1553798894,1553798938,44,205
setPolicyURI,0x39c9c9bf09462ce22a062858ac6a955400bea198ffdceef13bdbb54b9fa27b68,7458682,88728,1553798949,1553798983,34,162
setPolicyURI,0x5fa9de47efd07722342d1dcebb5c6c6b6e27855a1aae503a8b41a3551c9022e1,7458684,88728,1553798990,1553798996,6,143
setPolicyURI,0x12ff9c7cae2d3594e829b0b5b0a722dfdba8591a2a5a0d2bc7b5ace91342391c,7458686,88728,1553799019,1553799021,2,161
setPolicyURI,0x21cc76e07bd27ef07e52c3cab282b369f16e4ece7f5da4f44c835085fb78ee80,7458690,88728,1553799042,1553799064,22,159
setPolicyURI,0x6636e58a53c79b8502614c9877c3a5125678e4c21f22abde94e0d208b45683b0,7458692,88728,1553799089,1553799099,10,193
setPolicyURI,0xed2b46bf0dafc814d1895de9f5610c1a2b1a9e589db425c6f2541bc8803bb5ea,7458697,88728,1553799132,1553799149,17,199
setPolicyURI,0x9aa7da3294cd037536fd6c32ade4fea032b49c9779e7a54f7d4e9db5bced746f,7458699,88728,1553799159,1553799183,24,187
setPolicyURI,0x3635e608d9ce9d02a18f379e963265cab0f078a8587c6271c0450c61d2e21667,7458701,88728,1553799190,1553799200,10,183
setPolicyURI,0xe97feeb5932400ab4558fefd66cf234f6b092ee2e4d048e900ab44b8c7877fb3,7458705,88728,1553799213,1553799296,83,192
setPolicyURI,0x4d74cd3b500dd4b7ed233bcdb3858535fae26c4ee096f9ed1d90c64415ca71f6,7458709,88728,1553799321,1553799331,10,127
setPolicyURI,0x76ea8d01d06c9d8d3211a6c27d1031abeffe7a372198205e5dc09e2c3e0509dd,7458712,88728,1553799346,1553799348,2,133
setPolicyURI,0x5382ef1d64760899c575d0a27b1591e9374f38a75ee4241f26927b4b64cc3c11,7458714,88728,1553799370,1553799382,12,149
setPolicyURI,0x30a7ea8bfd4b9e69a21eb6918fc806a4480f546ebb5be6e016252c0eb580827d,7458716,88728,1553799395,1553799396,1,160
setPolicyURI,0xae3b2a3dec926fc890a25c765ce5ac3869024f2711e2acb06560c4f7e0548aae,7458721,88728,1553799433,1553799448,15,197
setPolicyURI,0x3bdba17f9be616d0d511098233137abb0d8d96154cf6260068dab7886e71438f,7458724,88728,1553799457,1553799479,22,213
setPolicyURI,0x70df42834669fda4e8fb998d03a9d2189324ec595283d747e4faf597545eb9d7,7458725,88728,1553799479,1553799512,33,204
setPolicyURI,0x8a50610ed377bce482deedbb6b3562d2aa2e0fd5439fcdb963e5ecbb8afd1f44,7458729,88728,1553799521,1553799575,54,207
setRoA,0xd0b6c5e44c40cddd085a97ef1b44648e6871c9a1c86edbd652f538d0eee42477,7456363,44933,1553766952,1553766958,6,169
setRoA,0x116fb7bcf08b18e824f3a8675deae97a8d6b78b0b16ffbdf6b6d9e71d6f0e1b3,7456369,44933,1553766977,1553766994,17,207
setRoA,0x9fbee118270ee68405595eba44257d62307e45bf3a79b0d46f94ed7e7c68c4af,7456372,44933,1553767003,1553767064,61,199
setRoA,0xfd881df32c6883d020e5dfa740de9401a4a6474c1fbbea3b6e329c27b5d3a051,7456375,44933,1553767083,1553767121,38,139
setRoA,0xcf4848e4277b67bec663bc62dc1aa1e60a272c04136ca5a04310be7703624004,7456379,44933,1553767132,1553767170,38,148
setRoA,0x4c687c6f3108bfdaaef2ec4ee28e5628c3d4c37419b9f4a096671524e1cdfc6f,7456382,44933,1553767179,1553767189,10,147
setRoA,0x51db3c3e3f87c3f11e6e64e867bae5e3271cc05a68950e048a5c3bd4085bf1f9,7456388,44933,1553767205,1553767254,49,187
setRoA,0x31c26ed1e40c4735d51db6f715d421ebe27bb0182f95a4806e1fa8b81a710cc7,7456392,44933,1553767265,1553767281,16,162
setRoA,0xf13ce0899c2dfe5f7a86026449dd48fc02c3c1e02f8863b5f83fa26353e98e2f,7456397,44933,1553767331,1553767339,8,173
setRoA,0xcc74d7df0f6374e8cf8ced8217ab3199c447b2ee9156cfac49188b0b0c5ad779,7456400,44933,1553767367,1553767392,25,174
setRoA,0x9cbbf7f359d9b8ec3acc8b58485b9f1076f3116c5b1ed46834b7e76bb4afa022,7456908,44933,1553774760,1553774779,19,156
setRoA,0xff2046bbc79e6804434942d8f5d29f5d5bf4f21ef3da5cbcd3ccd26ce577a93c,7456910,44933,1553774785,1553774797,12,147
setRoA,0x03b25a2f2c59a3dbc03c67cc70cfade0b733d655c5569a7bdf22388ff5d6e3c1,7456912,44933,1553774805,1553774814,9,145
setRoA,0xbcb8cd7e5d95b033f6a7ed5dd92ba6ef1d8af842ca929fde1b8e5e9d997a6f89,7456915,44933,1553774826,1553774853,27,158
setRoA,0x305f06fac6ab76e6553e515894a3fcab643c0f98c057c6ebe895a2b7613cf077,7456917,44933,1553774869,1553774878,9,123
setRoA,0x9942425689ae8ef97d85310467fb6801d1af179195e4c8d9eed34cd07ef4ee8a,7456920,44933,1553774908,1553774916,8,114
setRoA,0x67d2885ec1677d3527f1b35e07e2e3cbc3334bb97934e5f9ae955b68a2cb3ce3,7456923,44933,1553774935,1553774943,8,132
setRoA,0x599044b5f5c4dcad7ecbf0a9f59e5b21eebdf5f7af1031293c4363f24a391040,7456929,44933,1553774970,1553774992,22,181
setRoA,0xa2f1d47aa8697bf12ea86e39bea98480766fdfcba2f845cbdd42eae3bd5dc76f,7456932,44933,1553774999,1553775022,23,222
setRoA,0x8de33dae376b0d00051ac16b9160262ffdd54359a8d0e71fbe7690c02f420223,7456937,44933,1553775040,1553775110,70,258
setRoA,0x9224faf8582b1a2e4cf29c0980c7d82d87a171ea03aebcbb59da80c1406cfcf6,7456939,44933,1553775124,1553775136,12,180
setRoA,0x4b248d6b4e7b3bf88c580ab8b011aa3c9641ecf11ec5f083520791816334d646,7456946,44933,1553775187,1553775262,75,216
setRoA,0x4b5dbaf145216ff91556b8c80517c2760385227f3410de2491959da8762951e0,7456950,44933,1553775279,1553775303,24,175
setRoA,0x98119ff6a8c85fe452807854c43e9468fb1990fe0dac19ed0984604b0500c3d0,7456954,44933,1553775314,1553775353,39,157
setRoA,0xcc9365fafde05172646d6e87cdbdcc21f293061edaaae8255da831887f6c24c6,7456957,44933,1553775358,1553775392,34,143
setRoA,0xd6ae7c46ce36a9f25cd600d720839260075654e5a83706046e38739e5571d9c2,7458551,44933,1553797038,1553797051,13,227
setRoA,0x3dd0427415f6ef9b10e91179a66637ace28c33564ff2e58253670dabeb50c12e,7458553,44933,1553797059,1553797085,26,258
setRoA,0x375c64a65c898b16e3a3a5319b495b8127c3c0c964ff8bf902cda89c14d9ce39,7458555,44933,1553797093,1553797190,97,245
setRoA,0x71883bd17364f7940c339cb8929398c0cf5aac21f984a47479c2b8fae2f2ef2e,7458558,44933,1553797202,1553797208,6,205
setRoA,0x4c99e2433463f1cedefaf69cd27bca182b4cfa736dd4a5eadc17b050ef9dc697,7458560,44933,1553797223,1553797233,10,200
setRoA,0xc672bf4c6ab4167d987f759f3a7069a2592d1d00647f749dce46ad7671788d41,7458563,44933,1553797263,1553797265,2,252
setRoA,0x0e2b3db320659a88ffd69fb0244ec986283fd74ea70ce49aa8a6fed310eba459,7458566,44933,1553797282,1553797331,49,239
setRoA,0xcba4de3d1435c111780ec41fb463a9ca3a9a66197b2bbd32227c2a27d116d3e6,7458571,44933,1553797345,1553797409,64,292
setRoA,0xdc025ee04a27c4a9b66747d379576fabc3f6c722f5d20a171770efd55e86ee34,7458574,44933,1553797425,1553797450,25,256
setRoA,0xcce896d8e342ad3e23b9efe3a262503dd3ba64677caea381a01216e24f1c375f,7458578,44933,1553797462,1553797521,59,256
setRoA,0x102dbb39db3b80ad27da4350a0ce8d17f83c106f004d5540c865d82cf5bd25db,7458583,44933,1553797551,1553797637,86,221
setRoA,0xacd524073115ab9cecf745b510fe8850f9e2228bb78064dea47478651f63e3d4,7458586,44933,1553797678,1553797681,3,182
setRoA,0xc9cd3d9d71744e5de1ac383de82049b91ba15397be9c3b4dffb145a5375c7ad1,7458590,44933,1553797698,1553797718,20,212
setRoA,0xe1176bb35e9809e38ee9344a0a78a4079af4567bbbb3e2f41dacb5f2de496d42,7458592,44933,1553797725,1553797742,17,210
setRoA,0xa4a21ad23dcd6f9ca563cd0fb1508acde2c53b8a8bc333147fdd182a54d2a8d4,7458594,44933,1553797750,1553797769,19,208
setRoA,0x6657e131080d2baccd33692c7d2adb79bdbbdcc3915939737aa852ce351ef8aa,7458597,44933,1553797796,1553797841,45,225
setRoA,0xf9728551b11843f7a5d83eae03fbe50cbe0c271936f4eedc2e2f3e679b49b9d4,7458603,44933,1553797848,1553797920,72,245
setRoA,0x935cfa8fabaf8a93b73df6f78f2d7da42c70a0f541a364270986e0e628bdbccf,7458604,44933,1553797928,1553797935,7,175
setRoA,0xb76d0b73fd175b4ca5193b32d2aeabf6b1c6d0900762cdb2c4f8561f6b609906,7458606,44933,1553797948,1553797958,10,164
setRoA,0xff42a1b27cb66ccbc9317f03ee24fd73f613745f840acdaf765b760cac5e86e3,7458610,44933,1553797968,1553798042,74,163
setRoA,0xf2adf392530a4faeb374c576d7f80ba7cedf25a038d44aa783e4c1dac0ec7b28,7458613,44933,1553798051,1553798061,10,147
setRoA,0x37a920f1b84390d0dbccdce15772f8cf1fa09dfba48596637431ead652174254,7458615,44933,1553798076,1553798093,17,126
setRoA,0x962279d24daed0cfb373405221079a6eed4b2454d81e9cc05f54fad2c84cbedc,7458618,44933,1553798100,1553798112,12,149
setRoA,0x8829b97d81594a2b179bc3f96634b28c0673ced51aa07fbf10398877b0adc691,7458622,44933,1553798122,1553798131,9,161
setRoA,0xd18d2efb1350080f6eccc2ddc63d16058ef10776004418b9aa7920d1edf29dea,7458627,44933,1553798145,1553798202,57,222
renewPrefix,0x6b5b5b019366989f4a684cff9901126a3072d1adf999025a1f1437347240d188,7456470,37444,1553768410,1553768465,55,206
renewPrefix,0xec0d5debd3f359057da62466658210b6c4aecc00eeb11e8948cf5edd0d82bc74,7456480,37444,1553768561,1553768581,20,178
renewPrefix,0x3028f93a7dba185b8b4c6df2fa51714891bb96c27d6e8cb7c73b54d912975bb9,7456489,37444,1553768700,1553768711,11,295
renewPrefix,0x70005588a780b8e974e7a044ea0dfb04fd51ac558722f2ca96aefcf8032a12a8,7456499,37444,1553768763,1553768902,139,355
renewPrefix,0xc9ff8509d04215354d2ec2d181c7ebcda9ba71bb844a918918e95f9895b5f317,7456502,37444,1553768919,1553769014,95,219
renewPrefix,0x86d65e4576bc1fb2c9f6538a5c07075f1955833a67ddfd0d7bd5324be4173805,7456510,37444,1553769078,1553769115,37,206
renewPrefix,0x756a6bc1fa5490db573f0ce1dfa3a0c7c01c60926c9abe050098c95e5dc9795a,7456520,37444,1553769225,1553769261,36,208
renewPrefix,0x0ed03dbed2521bb65e98a0c02a882f95e0a45edda2c2d781977d25cbd7657895,7456533,37444,1553769427,1553769476,49,238
renewPrefix,0xe8fdb07c60a827066c49293c58eb10d9816b9a3386148531f9c0620180920f66,7456539,37444,1553769534,1553769561,27,174
renewPrefix,0xc640bc8f278105a5f0898bdd5d3dfef06d7321307b6b0ef2516a29fe34aaef9c,7456543,37444,1553769567,1553769610,43,197
renewPrefix,0x0f6b09cc7792ef194be56cc48c7ddc04b3797eacb76732719285ab8415c26f93,7456546,37444,1553769638,1553769671,33,175
renewPrefix,0x3f5f113f2b31c0373810feae27a15939de2c6bb4ff7d7f2f86199c0412c26f4b,7457035,37444,1553776185,1553776282,97,177
renewPrefix,0x31e412d765d36b21f3ba4fdbd3e85c80d78a8f64040b4659881b3e5c735e5b4f,7457039,37444,1553776293,1553776312,19,108
renewPrefix,0x930635a8b9adb4459e2c3aa10ba29148cc5a38b01559dd3f2a0c7f12bc887341,7457045,37444,1553776332,1553776356,24,144
renewPrefix,0xca147f74627782e54f7802035a3ea4ba291bec266674401422219f1f152e7930,7457049,37444,1553776364,1553776374,10,171
renewPrefix,0x6e3bc108428f3bc97ba6648867009dd8c73246574ad3365c644e64dbc49ed6aa,7457052,37444,1553776390,1553776406,16,153
renewPrefix,0x5c68b079732b975c8accd2b269a5f10f24bd8f42a8a43de50234ce300e49dc90,7457054,37444,1553776412,1553776428,16,142
renewPrefix,0x2d2b052c9ccf12340b838766b167e8531b9b3180eacb14cba0780ca58cc6e1b4,7457062,37444,1553776515,1553776539,24,168
renewPrefix,0x3647603fa6eb39af806f7eea98323dbe029b205450e5fd5717e07261969d2925,7457068,37444,1553776558,1553776590,32,257
renewPrefix,0x79fc6f13a16d1be76c2b7c9d4c9dc7121b33d4f0cb0a31b76a2fc1c285788f80,7457070,37444,1553776608,1553776611,3,224
renewPrefix,0x5a728a02f03bdc469cfae7ffe34bf1de23ecfcee9d3c4c5af789064c9b553fd8,7457073,37444,1553776634,1553776680,46,220
renewPrefix,0xe287b7751d467d2dec77fecfd0c537ae85c97626509e22d4d5fa07592f410cab,7457077,37444,1553776687,1553776764,77,240
renewPrefix,0xb5347673e7e1e4e359bc63368234ad86c4af5a6fd452cf583b9d6a4a85fcc7dc,7457080,37444,1553776773,1553776815,42,194
renewPrefix,0xef5d1654d56353166617e654e5c51fb43477416194442359aecc938c3a297c90,7457086,37444,1553776848,1553776864,16,254
renewPrefix,0xcf4d9f69f7dfd14f685ca051e6ee5ba840ac440c8b25fad4b67c0a02f346c578,7457091,37444,1553776891,1553776964,73,264
renewPrefix,0xa50b97e7c89bb115c52bfaaae092e91d3ee0961ba94954440c9046dad3e6e093,7458736,37444,1553799638,1553799670,32,207
renewPrefix,0x2f508b5dd6058ef6bb7897581ab21cef24f2fa765160a10e8c34d8f277b85a77,7458737,37444,1553799680,1553799683,3,206
renewPrefix,0xc73b990163b9988bd80d2b886d399d31e847a2f462d2173bde17c146401162c9,7458742,37444,1553799700,1553799762,62,310
renewPrefix,0x2777d72c3144bbd926b5ce4fde071ac650a82d89e83ecf52f8a61ee6386a1d4c,7458743,37444,1553799773,1553799785,12,262
renewPrefix,0xd228f5e037e6f1f46f87eab33b03f3255da229f55077be06d7bd1dbe59c8b934,7458745,37444,1553799793,1553799823,30,292
renewPrefix,0xeb961ccc6aac5a452e76992ab803f41a6e9eef28dae78091cf78037ccd72ae31,7458748,37444,1553799842,1553799845,3,260
renewPrefix,0x3449227a8c3e0e8752a4a7c775a5888de364a2aa2c2486c60000dad235645f3e,7458749,37444,1553799866,1553799886,20,252
renewPrefix,0x2ec1cf35b3c14aff20adbc4f144302e3e215ae1858dc351a4635d0465706e8f9,7458752,37444,1553799892,1553799963,71,280
renewPrefix,0x185cb374ab2f6f11bc6227ebf30799facd6ac30e20a841ad53eba66f78fefdd7,7458757,37444,1553799985,1553800085,100,241
renewPrefix,0x0431badd27db126e65432b5aae896d574922624087c98bc422a160bef0a85546,7458759,37444,1553800095,1553800099,4,172
renewPrefix,0x6f31b2550b399b822171d58210473ab888d40717b40186bde00b04f5946ade9f,7458762,37444,1553800117,1553800122,5,195
renewPrefix,0x7cb2555fd017b01dacb9aef62780bdac54027f4ff7df5206bcf57ab409fcac74,7458764,37444,1553800136,1553800172,36,203
renewPrefix,0x2a7f045f59e27c31134c02ed7a5d4b57046c144ca10e82310f590db72d12c478,7458767,37444,1553800190,1553800203,13,182
renewPrefix,0x81fd9376d2cfebef1ffd7cffeebcf3326eb91c0f0b76913dc4c6d8adcdb5a7b2,7458769,37444,1553800210,1553800226,16,213
renewPrefix,0xda3ae86808ba23a44ff4131b53e15f658e07e75ed922a5702f5af23a7065c690,7458771,37444,1553800235,1553800267,32,232
renewPrefix,0xb18b9be1b04ea6534074c3fac5455c6e7e5415b21813e22e549ec1b29e45c1b5,7458792,37444,1553800601,1553800634,33,199
renewPrefix,0xaef04f1b630e05d6e30c6251206e4366d4db72556dd2fab016c924712db45f20,7458795,37444,1553800641,1553800645,4,207
renewPrefix,0x9f1707f79ffe8f313cc9408c86a087b58f86c9dc2e3017ad1d9c403b6c10908f,7458797,37444,1553800661,1553800672,11,197
renewPrefix,0x3c1347fc1d5996e4bfa77b2f2b1cfb10cfc78dcc71eede0d46004ef93c9a3663,7458799,37444,1553800682,1553800710,28,197
renewPrefix,0xca07f5c117f0743b6097d15303582414d23d74e234efe8dbba51ea0e38d27d4a,7458802,37444,1553800716,1553800773,57,174
renewPrefix,0x13b0db6575c5f477765abda9e49449510f4006c0a9f497ea5b40205cfc6f918e,7458804,37444,1553800786,1553800800,14,116
renewPrefix,0x8e35ceb3db9de0ef023c71275ce03787a55c67e570b42bc3a230bebf3b6ff048,7458807,37444,1553800808,1553800848,40,147
renewPrefix,0x799552c65309ef9218a6c3e6b430a9d6db6351fd239bee642b023f97d1051667,7458810,37444,1553800864,1553800870,6,101
renewPrefix,0x6eb28ecdc4a5b1b8ad9116861b86455104c4e407a1e8d6c33c0d022e21b2099c,7458815,37444,1553800886,1553800891,5,109
renewPrefix,0xd7b8844ed4f5253bad80f727bdabbd41b70412804b38ab72f91043ed2717a163,7458817,37444,1553800909,1553800918,9,101
artificialExpiration,0x6fab4a035ccd0f2ef4040fca2237d14bc90bf453cee8ac618e02287b68e4c04d,7456552,27367,1553769708,1553769731,23,204
artificialExpiration,0x2bfd15a8ce80d3929ae5b4922eb4749ec58b51403b488085fe6de39fe86a8405,7456554,27367,1553769740,1553769761,21,203
artificialExpiration,0xc048c2623c19f6a3a44cc27ee7e1c5de183c5035d771efb5ea6f05e3a087e402,7456558,27367,1553769766,1553769813,47,212
artificialExpiration,0x6c1a9a38e9979ed487793fda9da02f36c4101834b59bad63e6041f1242d835b8,7456562,27367,1553769824,1553769885,61,251
artificialExpiration,0x9dbe219b2c3940321354b2aa0ece55d2aacd811c3a8dcdbd4d9f12d827c981a6,7456564,27367,1553769892,1553769912,20,201
artificialExpiration,0xa3cc890f68be5204e546f5f0c1a7b0aa0da22806769844201a42516b5a24a2f2,7456568,27367,1553769946,1553769960,14,194
artificialExpiration,0x147ba46d0e727cf3e3d233d0ebced36a5bb1f672befe9727547e81fdcf8b0845,7456573,27367,1553769983,1553770042,59,196
artificialExpiration,0x671ad5f19fecc371768b2a0fe1e3d7ab8da0f873d4c6be8abac4ededa13894bc,7456576,27367,1553770076,1553770093,17,162
artificialExpiration,0xed00760d77a9f9f72e65f79e63e5824c9144b035126c94e4a156370d78cacc7f,7456582,27367,1553770141,1553770152,11,406
artificialExpiration,0x30bdd1ce93d91ba0d928d3a37db765d71c2b0c7ef3501f1fc179270ebb69062c,7456587,27367,1553770201,1553770228,27,388
artificialExpiration,0x4b8153746297b05037e8414180cef946cf90f94f1aa544ec6c658ca841674ff9,7456589,27367,1553770235,1553770288,53,367
artificialExpiration,0xdb9644679acf7c2ac8212a240251c6d9a06a6c54f2a93e69307e9d10ba43b1ab,7456597,27367,1553770353,1553770576,223,322
artificialExpiration,0x501b145b4d8d595d9a40482d36176dd1f2ddeacf705c9eeaf2ffdfc5c7b0a22c,7456602,27367,1553770608,1553770618,10,120
artificialExpiration,0x5b0aae1fb2f34ea0ddcfc938ecf80c266c62d35d4b9fb4b69f068296d18fbdf5,7456616,27367,1553770773,1553770789,16,169
artificialExpiration,0x961d19cf7e65090a386c2d3c7014827a9c0e3cc6b98e2a839427efbb07fc8f59,7456624,27367,1553770835,1553770903,68,320
artificialExpiration,0x0f562095906d50c3f86eb69ab593dac5c7f688221cc14f9b323f05a574e1fd37,7456637,27367,1553771001,1553771201,200,372
artificialExpiration,0x5a5cc4001d5a830e59479599226a001182e4e50bd353d5492d584e203e1469ef,7456662,27367,1553771511,1553771553,42,268
artificialExpiration,0xb063be2fbff9b20cc7c76fceb9665e05bc15850b5695208d5392f2646652a4d1,7456666,27367,1553771561,1553771643,82,239
artificialExpiration,0x454411bd4ca42d2210c8fed395e531eb09293fa714c508c6981cd573d6959c35,7456671,27367,1553771701,1553771738,37,189
artificialExpiration,0x3eebf4dc3e1988965f1322f5d8486e23cca91f315ecd4729770847158eb471ef,7456676,27367,1553771761,1553771789,28,284
artificialExpiration,0xe0b1e1d2aa4c01934eb9acae3d5525d3cc6bbfeace364c0ca423564d3190dc18,7456680,27367,1553771823,1553771856,33,270
artificialExpiration,0xa0c8d251221cbfc5dacd4c75e91f3018d0a45ffe6cc27c5c63ea9aa41e4eb952,7458134,27367,1553791154,1553791181,27,130
artificialExpiration,0x808f27a8f7707624a718ed76d83b07efb7830b71ec14a1831ab419c4f0336c91,7458136,27367,1553791188,1553791199,11,122
artificialExpiration,0x3c5c446d4713a64a097879cc490201cea921104217893c9b14b3decfbe7344d2,7458140,27367,1553791232,1553791239,7,135
artificialExpiration,0x3d0aa96e25963a0707177a6b883de116d5da156e8632c1f638a02799570ece69,7458141,27367,1553791260,1553791266,6,147
artificialExpiration,0xb2349224f1cb23baf2b0300285027303e96d02a11bace4dc82a7ad43425818dc,7458149,27367,1553791320,1553791340,20,209
artificialExpiration,0x5fc71c3f20e5e80d696cdb0f9bb5344ad2582c9f2156c25e36599ab621304105,7458154,27367,1553791369,1553791421,52,234
artificialExpiration,0x0603d5faa1d13deb4f5627fe7810525a6094369a70d5b99fa724e97e9521135b,7458177,27367,1553791743,1553791747,4,223
artificialExpiration,0x2a0adbbff0cf452956a86843d2677dddeb50df7c566483406bf9e89402f5fbd1,7458182,27367,1553791775,1553791875,100,253
artificialExpiration,0x0a96d8d7695eb1f85430b82bce20b5f8bd410ff090c3f966a125a76d8c636869,7458183,27367,1553791884,1553791887,3,153
artificialExpiration,0xabd0895531e6801a8b277532c90fe434d3a15e751bb09fca672d2417ac011796,7458186,27367,1553791904,1553791930,26,166
artificialExpiration,0x04df96a6cce0e535ef9945322eb57d82765cde229b00fec3bee6d1c6a5b07fbe,7458188,27367,1553791936,1553791943,7,147
artificialExpiration,0x8cca218b970521598e41f6cbf60ce83e38440f7215b5080af8974703f21e1a68,7458192,27367,1553791961,1553792015,54,176
artificialExpiration,0xe7f2ed850bc9b4f89ffce4845283f16482c34e2cd8cfcba023c2342679023abe,7458194,27367,1553792023,1553792028,5,126
artificialExpiration,0x24f730c6fcb13d93a98213b13bf9712292ecfddfcc04f7cb11f68633089909be,7458197,27367,1553792040,1553792062,22,173
artificialExpiration,0xcce387df4a2830c0eb4c1ba928656595d4f859f939e37c7cd3b1f012f03c7ec1,7458199,27367,1553792070,1553792079,9,164
artificialExpiration,0xfa4081820b6729e14299fdeaa1890f6b4c4e8d6e7902d691501e34680e2a79c3,7458205,27367,1553792094,1553792140,46,227
artificialExpiration,0x4533732c3b1889bbeff551e9fe493dc03d45ff648e8b027a09f6a98977e79f26,7458208,27367,1553792154,1553792205,51,213
artificialExpiration,0x9a67d311425e29b6c3c0667fd32de5fa584395c7edceb595cc3fcbee8f625eda,7458210,27367,1553792212,1553792215,3,177
artificialExpiration,0x6aa18a18c996f653f1175cdf6e6dbdc526dddce14d9f47b5c2d6698eb6d8de7d,7458212,27367,1553792235,1553792248,13,194
artificialExpiration,0x463b4d2f3ea3b9c08461c24eea475021309e79dcd99095676f1f732046a83eed,7458214,27367,1553792255,1553792262,7,214
artificialExpiration,0x911cf87d80c2210a2d363bdd8517de3928c10fc667cc3e8885e1be9e77d88d20,7458216,27367,1553792284,1553792304,20,188
artificialExpiration,0x81fc099021aac331d5b6269f9bd6f34369b5a1627d0621357371139733565115,7458218,27367,1553792317,1553792330,13,163
artificialExpiration,0xb2faea09a9c0e4e3dd39b1952e4a046138d6d86fa68b0289a9370e245542bf05,7458223,27367,1553792338,1553792406,68,284
artificialExpiration,0x8349014df28d5fead09bf9e24795e3fd6b016c11fde2ee3c57721daa2a2bfb47,7458228,27367,1553792413,1553792472,59,282
artificialExpiration,0x264b1eaaebfc1df163d477e86d6c74b2cf2be2baa98145f6ad73ee350b73bc52,7458232,27367,1553792480,1553792498,18,235
artificialExpiration,0x9c7f9874fd383ee98bac9ecd1d72df1aad3a3165d622218543c6d5c25cee1cd8,7458234,27367,1553792522,1553792613,91,236
artificialExpiration,0xbcf752169b5b5f87d11bf5fd697e5ae2a8f7ff747cd77294f8c5dd7cb822a220,7458240,27367,1553792637,1553792695,58,208
artificialExpiration,0x677b016342e747f52c7025dbf0a52d339db45d8b6dd8cd94951b98d5f0b79609,7458251,27367,1553792737,1553792844,107,276
artificialExpiration,0x3ff102f85f1b978c9f6561330b7ffb99302a91c7c9001112ac30d22fed1f1e24,7458255,27367,1553792852,1553792895,43,207
artificialExpiration,0x8dcdf3e13169aeebb40364a15fba21fd0adc2fa69f7b44638a760bda08756c5c,7458257,27367,1553792903,1553792914,11,191
artificialExpiration,0xc688d49d1b8dd357bf119b26b2ef3ce0b02d656b2208988a2b9ab67227a912e6,7458827,27367,1553800989,1553800995,6,209
artificialExpiration,0x91c9f7e28b2c64341b8714d8637e30b2f39f29202a442c481ca48bb276ef6053,7458830,27367,1553801011,1553801034,23,229
artificialExpiration,0x9b0414ab82920d480ed277cf0f08e082569075b3b01c03a9f2783d044c27c6d6,7458831,27367,1553801044,1553801056,12,204
artificialExpiration,0x7de88d34903705fa813ae7439edfd89a681d9e4a2cc9d23b4888c4c23ff8a18c,7458836,27367,1553801067,1553801170,103,235
artificialExpiration,0x97a62c6933e4de1f78b947fe96ca285d02a12936cc676d0fab2df8f7aa38d744,7458836,27367,1553801153,1553801170,17,149
artificialExpiration,0x7398f33fa01496f14f1abe355267224de3918cd8426b53bca3b2620dc9b3a84d,7458839,27367,1553801180,1553801198,18,129
artificialExpiration,0xb14a94cae88eb903a0da7dbc5aa991bb9bee91e526b0a433edee062e5a05728f,7458841,27367,1553801221,1553801225,4,119
artificialExpiration,0x95fdc195e6418ace5d1777423daa638d0bfa54cb61d3cc2c880d26983756cfe3,7458843,27367,1553801240,1553801248,8,120
artificialExpiration,0x61b101cffa728578cd91712cf4c39e836a3fff51201fb1f21696ad3755d77bf5,7458846,27367,1553801269,1553801280,11,118
artificialExpiration,0x85077a975d3aade227e50214b8c32743cfdad7cc281042fd8ecfe9296560a90f,7458846,27367,1553801271,1553801280,9,116
artificialExpiration,0x8f0034f7379aafc3822136baded46f3ee5127ee4f3c96b6847e512fc33b2c14b,7458850,27367,1553801303,1553801306,3,151
artificialExpiration,0xcd8cf302694c80cd99c0f4a38678d6119c5a9f414e382279cf9992f044d28509,7458851,27367,1553801305,1553801309,4,178
artificialExpiration,0x1e6b2d49cd98f2b611406339e82955b36613260c7c53272d31ca8e6310c4157c,7458854,27367,1553801326,1553801346,20,250
artificialExpiration,0xaa8de258da4692d7d517f7f0ee2f58abe45963c2816b0ba8f50bc4b2e17413c2,7458854,27367,1553801327,1553801346,19,249
artificialExpiration,0x61182c5f2494dca4c04d73f1a7b1eecd221d58cf278aff667bcf29ead1081c94,7458856,27367,1553801355,1553801383,28,230
artificialExpiration,0x29cb2458005af2ed3dbadfeee68d8a9ffa0042bc46a0bfd5d2b8c06c93affa5c,7458856,27367,1553801355,1553801383,28,230
artificialExpiration,0xc98a098b1d59086d454e4ffd055c0365ce82a94e8e79374ef274232de77fd3d2,7458860,27367,1553801407,1553801435,28,222
artificialExpiration,0x20ba4a4953c27e6534031d98542404fac3584e73d081b87a131ddb1d58e26a44,7458860,27367,1553801408,1553801435,27,221
artificialExpiration,0xafc07d31a1e173bb2170a04b56c493e6ef147d59382d18d7620ee179b6c0fc9d,7458864,27367,1553801445,1553801517,72,261
artificialExpiration,0xdeab785866fca2f4a925e45ae17ed5a94d6d0b196e1f0e9f907e691ab3495a7a,7458865,27367,1553801446,1553801553,107,276
artificialExpiration,0x7c385f8add21ca6cb14f97e530c16f86f4ec2b68512c7bae36392f108c9a6d7c,7458866,27367,1553801528,1553801576,48,203
artificialExpiration,0xc617b97478585ec3aba447d3765b401c44988552c07111cda02dea2cdb3c897e,7458866,27367,1553801535,1553801576,41,196
artificialExpiration,0xfea1c9f8db798f0de4661849fd1bd362340243216333c39df108808cc464e0c6,7458874,27367,1553801633,1553801691,58,273
artificialExpiration,0x9f362f0a2a20e0ad82be8a57d9d5f07ee8f77775a444661737b3c4543347b3d4,7458874,27367,1553801634,1553801691,57,272
artificialExpiration,0xfb64061d84938c86e102a8d373b98d62758c3717916c76dc1b4ef7602d7980d4,7458875,27367,1553801698,1553801704,6,253
artificialExpiration,0x6ffade6560f5516987c97e691dc7549d0de062d69d46bb42d97994f58483a8ec,7458878,27367,1553801699,1553801731,32,303
artificialExpiration,0xa918d81228725f8dac71783e78e94791efe29bbd26aa01fbb18ee361d8cb7dc7,7458878,27367,1553801719,1553801731,12,283
artificialExpiration,0x568e3c9d4c464a8fb52446ac52acd4617ca2c6f80ae7b503c083c60cae718c0a,7458878,27367,1553801720,1553801731,11,282
artificialExpiration,0x6602df4b278515dc1bb880bbaf3c68acd969f37248bcd08914dc18749b01811c,7458880,27367,1553801744,1553801774,30,264
artificialExpiration,0x417d6c92bab74386188b4962572d9d5d4357644e64775351cf95da218c4595be,7458880,27367,1553801745,1553801774,29,263
artificialExpiration,0x79e844d9271e522d5ee715ef2023e20eb54fb060a3cc1872f9b7e25edf796981,7458884,27367,1553801784,1553801857,73,271
artificialExpiration,0x4ff78384f1cc4c16c5d286b54cc4a89a8b3362f441b7752ebbb71d5b5aaec13b,7458884,27367,1553801785,1553801857,72,270
artificialExpiration,0x076ff80e896fca67176efefad752902cf49f0ede7ed68ffa501774533d57fc9b,7458886,27367,1553801862,1553801906,44,197
artificialExpiration,0x0f51bbc5880173c4e431627114b3ae20f601fd7f296d42e506c92dae9d038ee9,7458886,27367,1553801863,1553801906,43,196
artificialExpiration,0xd1723684b368fb9a003dcc3e53a6a95ee8d7634e6c20967918b936e6a2f89417,7458888,27367,1553801917,1553801967,50,175
artificialExpiration,0x67d0199de3c473cf28283c39eb400f594c07839615be8ac6aa7267b65783af1a,7458888,27367,1553801918,1553801967,49,174
artificialExpiration,0x3d8516b12ad9f90aaa89a85aab92876426cf4a7c38f2db6ac802fa06ff85d3fb,7458889,27367,1553801973,1553801989,16,136
artificialExpiration,0xf24cebcb773ffdfb3fbf18cabd7d351f67c70685554c127a9d9d8521ecbfcbec,7458889,27367,1553801974,1553801989,15,135
artificialExpiration,0x9439f9b9c3a4e4439ad1f299f41ef413d91a11b50a8ee56b96991b36b2064e8f,7458895,27367,1553802031,1553802053,22,160
artificialExpiration,0x3c870333cfa5d5e55c90f3e313efda5f99f18e0cf18d8c0f588b8ebb9cb278ea,7458895,27367,1553802031,1553802053,22,160
artificialExpiration,0x2f10e182b133de6de7d50e284b1a2255e33cc378cd04f3c72d0c99c07eba30f5,7458901,27367,1553802060,1553802109,49,206
artificialExpiration,0x67770e59733032fbb25bba348d51dd211417056a09464c5b00e1fdf8b012bb65,7458901,27367,1553802060,1553802109,49,206
artificialExpiration,0xa2572203696e3390f843246cbefd8f1941a0b6bc32a02d17834fddab430589c1,7458903,27367,1553802117,1553802137,20,172
artificialExpiration,0x84871ecf35c03bb2ceffb4c92e50540b1d48fc129d97fd955bbce4e563f236d7,7458903,27367,1553802117,1553802137,20,172
artificialExpiration,0x3315300920ad40f0c14b90b339ea18f35d0a47af3dd9aa84bcb2a156edc0d401,7458905,27367,1553802155,1553802157,2,144
artificialExpiration,0xe7b34ae6b293c05d6fe9139bb0fe400fbe04ca91ddd2470db0f35b6fd7ef52d0,7458905,27367,1553802156,1553802157,1,143
artificialExpiration,0x88aa8fb16ad3b87a91ea60a16c336aeb69737b5a2b9aaf4cd5b0f43a7ebeddb3,7458907,27367,1553802177,1553802191,14,142
artificialExpiration,0x39375a144e0d1d72e1ecdb48639dcfd6e1226263a3012cc37234e0845ac825a9,7458907,27367,1553802178,1553802191,13,141
artificialExpiration,0x9fde127bfbaaf252629e246284f01a8922700e910a9999dd98bee3a1736aa7bc,7458910,27367,1553802206,1553802229,23,133
artificialExpiration,0x32d3cc227b1265b5df33f1a8bbf0f4889442be5b92bf185c6a0e77cac2623116,7458910,27367,1553802206,1553802229,23,133
recoverExpired,0x206567079c44a4846d57ac7846b4a153c607f9f38567e42765594b200079bc4c,7456687,60962,1553771885,1553772031,146,378
recoverExpired,0xc7e020aa8e15a3e4981d41c2b80922d11d6a89ccd530e1933f3f549f306c785a,7456689,53462,1553772042,1553772050,8,253
recoverExpired,0x7eeae4654b29ebc77bb9b89430e8089ff455ec786fa3b59d7bfc7173f0f6d599,7456694,53462,1553772108,1553772154,46,258
recoverExpired,0x7ddbd0668ed1dd2a1021c0a632d6882c90ef9a41d46fadc2b70b3b3f822a0d14,7456701,53462,1553772205,1553772295,90,264
recoverExpired,0x0501dde69cb59d40f71a53ee2648179e37c3b9aa2bf9b982160d6ebe60ab5d82,7456731,53462,1553772611,1553772737,126,233
recoverExpired,0xd5215ccebca47ac398b123a93c98029d3499060735c2fd1fc69a04f787e2f914,7456745,53462,1553772853,1553772860,7,173
recoverExpired,0x10dfa0db5e31588493610fd37c1f6f8f2e52846d428d1c3e61af1e20055f16f6,7456749,53462,1553772880,1553772936,56,167
recoverExpired,0x588136b63790983e14cd674c7452e45c4c2cad06c5c975b670118e2364aa769e,7456763,53462,1553773060,1553773066,6,153
recoverExpired,0xbfa0bcbf1cc36d0a4ca1fdd505ba57ee0e40adee51b21783cb67db121d8dace1,7456766,53462,1553773081,1553773097,16,147
recoverExpired,0x3d1f5ef9a67a8f8f6888cffef04c8a12d54bd71967275464af36d21c3333772d,7456769,53462,1553773107,1553773175,68,172
recoverExpired,0x23a13c86710d5c26ce0f949cf05a56c7fcbce216c92be3e625363849e3be694d,7458265,53462,1553792946,1553793025,79,295
recoverExpired,0xf5a2d1f15e584fdbf81ad5c1d4783b62ea1764fc8c62b2409549c2457c5d24cb,7458267,53462,1553793038,1553793059,21,214
recoverExpired,0x3e920e4210a8008d880751bac76036e33059a947288e9414277507a9a092416e,7458270,53462,1553793066,1553793114,48,189
recoverExpired,0x4383aac58d04e5227c7dea3ef15abb4b546558b844fd2d95219aa76c89b701ac,7458271,53462,1553793121,1553793136,15,160
recoverExpired,0xdf595b9b41210a3ee8b6d2b0de24fd7ae8859b81fd0a44cf9ed73a7e860e6eee,7458274,53462,1553793142,1553793215,73,161
recoverExpired,0xba240073ca3981f2c7eb7e3ee19390554ae057edf25a0062be8531965b6286fb,7458277,53462,1553793222,1553793241,19,120
recoverExpired,0x9c3686d5e759d0e5e29aa9786e0c62aff9f404e8c04189a3289b4985fe87a832,7458285,53462,1553793259,1553793289,30,143
recoverExpired,0x4b3ff188a676c91a669c952adbe1cf29d0f0f3956212a2bdc526ed6b989c0530,7458288,53462,1553793299,1553793331,32,138
recoverExpired,0xacf037f1ad4bd3ca275f8401ace507a796a5a7a5dec4cf4de032f5454f52b923,7458290,53462,1553793338,1553793345,7,113
recoverExpired,0x1498c3c40326d5688f9d3cce409269ddb977d89ab8b25ae3dad1a696555485c3,7458292,53462,1553793358,1553793367,9,121
recoverExpired,0x0ef7df8c07fcfaee7179e4ac279c1ffa173665a1557f5ebaf13392c63ea9709e,7458295,53462,1553793377,1553793384,7,116
recoverExpired,0x31a702f38f51824f29aa155bcb35b7e7733a1c54cd15ce5409e7a75daae75aed,7458297,53462,1553793401,1553793402,1,112
recoverExpired,0x82b8dd203129610e053723daba3f30823bae57a0626f6517d9d10929b87c577f,7458301,53462,1553793424,1553793442,18,142
recoverExpired,0x770c3a409745259edcd5cdeace33a3002fbccf2b0ae0e2fd81b6b7745968caf7,7458302,53462,1553793447,1553793451,4,148
recoverExpired,0x82057fa0e9668bdb8c160616dc3b1539a1808696902656893be9e7ffbd98a978,7458305,53462,1553793467,1553793487,20,150
recoverExpired,0xaaaed0d3883d7eb653ab4342fda5b20094f046a5bb3fca6566b60fc9d9ab4797,7458926,53462,1553802378,1553802419,41,165
recoverExpired,0xc2362915a6abe2e814416010a2ff74941b78905c3165850b35742ef5346c081e,7458931,53462,1553802433,1553802493,60,173
recoverExpired,0x012ab725efbb418f93efb2da27d6c62d1860421a347a5c5b33d3ca57168fd895,7458933,53462,1553802498,1553802507,9,151
recoverExpired,0x012ab725efbb418f93efb2da27d6c62d1860421a347a5c5b33d3ca57168fd895,7458933,53462,1553802498,1553802507,9,151
recoverExpired,0xcf515a55eeb8b035d9e3a6150cde7ebbfcdc4325658f3b93124f1d36091078d8,7458950,53462,1553802746,1553802780,34,212
recoverExpired,0x89351aab76aa1af84572221a3d88e0e7eee168d46167a84a53a665a964f9e9e1,7458954,53462,1553802793,1553802826,33,193
recoverExpired,0x25a7a6f9843f3a4f612074deb575a05370be40c27b597c7c066307760367e666,7458956,53462,1553802828,1553802868,40,234
recoverExpired,0x43bdcefffbe7946d368c8f7664a7289f131f69b6b9dfcb65a7ead0456f2e46c2,7458957,53462,1553802856,1553802876,20,210
recoverExpired,0x088fbf843f188d151261c77d9a3910a7cd2f22cbf748820012b736540113a224,7458959,53462,1553802882,1553802928,46,200
recoverExpired,0x2a8616bdcb5be1afebf44a9fc08445be70ca6200f7d12862776cce390402b1f4,7458960,53462,1553802919,1553802930,11,202
recoverExpired,0xf3565b79687e43978b6748e502f73260f1f13a10a11ffb853a5b2e5bcb934efb,7458962,53462,1553802957,1553802958,1,182
recoverExpired,0xc805751279854bd1079f364c788b26b48131ca6e339404eb2dcf0d457a99e377,7458969,53462,1553803003,1553803066,63,183
recoverExpired,0x7105da64d55b496f54739fd2590941961b83271c810ee579daa2b3b1e3d48614,7458969,53462,1553803024,1553803066,42,162
recoverExpired,0xb8c623c54b5c672cebf3dbcc94fcd83e3c2d0b04cc90088ab4e7770a0952c7ae,7458974,53462,1553803136,1553803139,3,98
recoverExpired,0x1ec747bb7600ca31dfa42872d955fe5563af7ffa4988f50097cb26835394a291,7458978,53462,1553803157,1553803165,8,155
recoverExpired,0xb7cdcadc83aac55f415c79bfab676b4d4831f841b2ec294b774e77880ac0f1db,7458981,53462,1553803178,1553803186,8,197
recoverExpired,0xd55d730ec3984a4c4441117e7542a4ba5c3b9dafbb7a16cb79e7bf0e3b5194bb,7458984,53462,1553803196,1553803206,10,223
recoverExpired,0xb9b79b87bfca44b0e5e9c48c2d9e5cf3ab2b93113c99d965a950304a51d959b5,7458988,53462,1553803219,1553803296,77,306
recoverExpired,0xcffba412123cd414254a2d8cc111e42ec80b8e916e770b585a45453bdf840656,7458988,53462,1553803237,1553803296,59,288
recoverExpired,0x4bc659e3061fa6dd3ed5efaf2deb9c0c8d3abb84a354c019c5d3791bc828f4f7,7458991,53462,1553803268,1553803315,47,271
recoverExpired,0x65beaf8ccddaaae1b835c3a7d03b838451ec50444e4da967b799a91eb47a65ab,7458991,53462,1553803310,1553803315,5,229
recoverExpired,0x5ae6d699430505869d9b196d0e4083b933bb6bcf7e3d5cce569f81c9ceb583bd,7458996,53462,1553803330,1553803419,89,262
recoverExpired,0xa40abe81bab2c59c8f01bf1efc745d63e482ec4280e4c5ee85ef2553afadbc72,7458999,53462,1553803339,1553803521,182,284
recoverExpired,0x4e3fa99cba8b080d43242551547e6f628d48cd47ce306b9d466f9d188a62ad70,7458999,53462,1553803428,1553803521,93,195
recoverExpired,0x67340bc8e5e157e151751dd9eaae2033e274b2b4890aebb4ccc1b9af6dc1a06d,7458999,53462,1553803488,1553803521,33,135
delegatePrefix,0x6152223f425c05c4b762cb398862a8aa4ef82654a6bb10f670a76884d2160a1f,7459237,1388328,1553806373,1553806383,10,158
delegatePrefix,0x1e371a4e0ac9a8b355a5e0c59ff828844ff757f72e5146bb651555e545b3ac43,7459247,1184674,1553806470,1553806482,12,275
delegatePrefix,0x217b8e33ece2e6340ee218dbddb5e4f237041b98939239827b328f1b8e7c0d56,7459251,938970,1553806507,1553806607,100,266
delegatePrefix,0xaf2d06817ce8861b02d0e834f7e7142259b2808feacc97d103e09db348f974ce,7459251,1307484,1553806594,1553806607,13,179
delegatePrefix,0x05953f64d2c0c21d3835a5f363b30ee446a4b3d72e045f357706aa91b523d314,7459253,1353910,1553806628,1553806655,27,174
delegatePrefix,0x1678552ef99b042f4da4e44078f59323d1440270e2054239b01ef75ccc144492,7459255,1307473,1553806656,1553806680,24,177
delegatePrefix,0xd23aeb60c2a1b149cf3b5c79572e0f0b7155e7300b9e98dc977ff2d783db648a,7459258,1246036,1553806702,1553806732,30,156
delegatePrefix,0xe42559f57bce9300de0717a5909745c632ed0310080801ecccff7747d83911a6,7459278,1247000,1553806883,1553806931,48,362
delegatePrefix,0xb7f0b1ce71845ca706e0789ba780e204fdd6acb17b31357f654b4e247bb15a6b,7459280,1246100,1553806917,1553806974,57,365
delegatePrefix,0xb742d73f17a498d0117d7474b3e4d83b5e631bdddefbb675d074564c58e08558,7459281,162853,1553806943,1553806983,40,345
delegatePrefix,0xe89e5abb7e6ce59f2103045cb69f12c23bfd8f3702dd83f5abd4469f42300687,7459284,1123248,1553806999,1553807152,153,338
delegatePrefix,0x167274a7e554ae75401a748325e46b2d2f0e5926d40f553de02f29689a33fc58,7459287,1061822,1553807163,1553807196,33,203
delegatePrefix,0xf3a140378fe2d58233b6d0c75ad52d869c4fa57087ad29e6280a81e74077d281,7459290,1000396,1553807195,1553807245,50,219
delegatePrefix,0xd96fd4ab4a1464e0b256e7604d2bb40aa7ad7ccf23947ee58c1a506b7eb46406,7459292,162853,1553807204,1553807282,78,260
delegatePrefix,0x7e2abe646cd89a565afd001fc302fdfd539016816f39182d763afe544302d255,7459294,877544,1553807266,1553807299,33,223
delegatePrefix,0x513c58cac07918d68b3e3e4a6f918b285769a23a75285d87094af0ea10b7bd90,7459298,816118,1553807314,1553807360,46,221
delegatePrefix,0x93e824948f3ff6e3ff5d8227947ed1e3ff8584afd444d28191467c82a06bfdd6,7459300,754692,1553807370,1553807381,11,194
delegatePrefix,0xf36479598b774dbc3903fe1a80c4e71b6864a2a8a065f967e3c8744688a09280,7459304,693266,1553807456,1553807464,8,128
delegatePrefix,0x200b53b5fe14de22ca0ddaa301cd7e45163f9010dedee66d03c24f11186687dc,7459306,631840,1553807486,1553807489,3,137
delegatePrefix,0x09988bc82d897b4e9b62411366f3f3fdc2b253f3e38b63dd59ed79ac1cf7549a,7459308,570414,1553807516,1553807517,1,192
delegatePrefix,0x50fe0bb3f654f87f3db4d5037d62eed6b78ab9c3ed52ae041d3912e5e45671b0,7459312,508988,1553807541,1553807564,23,203
delegatePrefix,0x0f54e5c9524b19a120e2d8a4135de7c22c1c876737545746a94626efb128fc3f,7459329,1061748,1553807766,1553807803,37,180
delegatePrefix,0x2cb5b192e8503306ef859e7d1d28104c60d8b554cdb313d064aaeed720476339,7459335,693202,1553807817,1553807893,76,176
delegatePrefix,0xf3e42fd3069aec8f9881b4a278fbc7fa49277cf01e06e1c80725a16508ab3357,7459342,754628,1553807941,1553807953,12,121
delegatePrefix,0x47051fb6ffeed35d7d97c46a876fad93b46fe64ef678d2272cafab5deed542e1,7459354,693170,1553808054,1553808062,8,163
delegatePrefix,0x4ee52b9ef149727a31492867c2ed3030e4d0881d73351e4d407b777aabe806fb,7459357,816054,1553808087,1553808121,34,165
delegatePrefix,0x3fd4476fffc1051aae187e8f9ef887a75dd5ad956f32439f89c3c968da32c56a,7459359,693170,1553808140,1553808143,3,125
delegatePrefix,0x2bc97d1e860ac5797d206b1a813da457020fc28c264e1157b08352ce297b22fb,7459361,754596,1553808163,1553808171,8,151
delegatePrefix,0x74e4aa94bd81a966855310f7598c890c8f681483568c3c1b9eb29450372d095b,7459368,693138,1553808220,1553808240,20,133
delegatePrefix,0x69e5e20a4c642ba505df49a86f537d30c134b444c4aa4c0a4d91ad16d65bf582,7459372,877480,1553808269,1553808281,12,127
delegatePrefix,0x5564e8a8088930aaa71324b528ee10efca09ff96efa3eba23135d6db018b5f62,7459385,816022,1553808385,1553808415,30,109
delegatePrefix,0xc51fc0d0741e47f1a464d1cc1a585652157de798a69b5a4f289bbbe31c82fd2b,7459390,693138,1553808440,1553808446,6,90
delegatePrefix,0x64db17fad91e4e2b36e046383fde802455b66d8f6eb2a7b2ba1fee3949fd273c,7459391,754564,1553808444,1553808457,13,95
delegatePrefix,0x0c5b8b96e090838f6d8c17ac1b8dc45e0ced286f9600fe1f584459bcc75ebaa7,7459391,693106,1553808448,1553808457,9,91
delegatePrefix,0x900185a56136c452d9eecf4b61502de10f42ac36145e03aba387838f66f176e5,7459399,441150,1553808496,1553808519,23,127
delegatePrefix,0x08730eb2da7d63a576eed08c5c2fa5be3bfa36345810044621cee6fb165a46fa,7459403,508796,1553808528,1553808539,11,156
delegatePrefix,0xff2cd942e75e398a737ec04f4647f5fc7ffdd8492f16c3325e711835b5cbd5de,7459406,441118,1553808548,1553808592,44,192
delegatePrefix,0xc9c20f58034d6583731883cd415302c4f52ae9593fa761ab3ee0326f9462693f,7459406,570222,1553808570,1553808592,22,170
delegatePrefix,0x0c1a6389471e1acf70d8971a11fe789af3b7f299aa89ad82c21464fa74f1da43,7459409,441118,1553808605,1553808610,5,164
delegatePrefix,0xa37bcd7d1ea614f758fa8514d10db5cfbc61c9099bc22d1dee6c79cd207e372b,7459417,441086,1553808720,1553808731,11,149
delegatePrefix,0x18e9d1627bff58c31f7dfc459438bf019ae2535e42d9c16173f37a985f9384d6,7459418,631648,1553808739,1553808740,1,151
delegatePrefix,0xbaf3a96dbb74aa5e4c2f12c9aad395391cedd328b263fee9dfad212647e6a45e,7459424,441118,1553808810,1553808841,31,201
delegatePrefix,0xcc7a2fd2d3205afc3092e42dbe8b01e538d70b4c9045981cf6f50fee4789e5dc,7459426,508764,1553808842,1553808846,4,196
delegatePrefix,0xf57ba3771c93198b5f74ad0d0d5feaf544a1b93737ddd350c3b7241b8ae0f4e8,7459430,441086,1553808879,1553808890,11,191
delegatePrefix,0x96d958390d33f1564866e89f3d563100816906dcb9519d59dd83314e386bba8e,7459433,570190,1553808910,1553808915,5,184
delegatePrefix,0x00bb934706dec511236765217cd3e8cb5afe36be092b4ad5f691fb9ee657bff3,7459436,441086,1553808933,1553809011,78,173
delegatePrefix,0x39bf47565162ab39c6350d3da716d44c8fd910d25e43ce02679c6b749f234fd9,7459436,508732,1553808977,1553809011,34,129
delegatePrefix,0xd169ce99bee8d1eb70fae3c2db9ae08994c7f6af0aeb1de0f3740d5720aeda3d,7459437,441054,1553809010,1553809034,24,102
delegatePrefix,0x4af8fa231acfa065fffa1aa1df57168d7dfd4241b12da8d5abc2979f0dcc52b8,7459448,1122337,1553809100,1553809106,6,137
delegatePrefix,0xec4720cf90d0b0739621caa3466890c1b8cb3da066bc0a68c0ee8baa5daebd84,7459457,1122337,1553809154,1553809161,7,216
